border_size=1
usage=map

Ket         , Ket         , Ket         , Ket         , Xos         , Xol         , Xu          , Xu          , Gg^Es       , Dd          , Gd          , Gd          , Gd          , Gd          , Gd          , Gd          , Gs^Fdw      , Gs^Fdw      , Gs^Fdw      , Gs^Fdw      , Gs^Fdw      , Rb          , Rb          , Rb          , Rb          , Rb          , Rb          , Rb          , Rb          , Rb          , Rb          , Gg^Es       , Re^Es       , Gg^Es       , Gg^Es       , Gg^Es       , Gg^Es       , Gg          , Gs^Fdw      , Gs^Fdw      , Re^Es       , Qlf         
Ket         , Ket^Ii      , Xos         , Xos         , Xu          , Xu          , Gg^Es       , Gg^Es       , Gd          , Dd          , Dd          , Gd          , Gd          , Gd          , Gd          , Gd          , Qxu         , Qxu         , Gs^Fdw      , Gs^Fdw      , Gs^Fdw      , Rb          , Rb          , Rb          , Gs^Fdw      , Rb          , Re^Es       , Rb          , Gs^Fdw      , Rb          , Rb          , Re^Es       , Re^Es       , Re^Es       , Re^Es       , Re^Es       , Re^Es       , Gs^Es       , Gs^Fdw      , Re^Es       , Re^Es       , Re^Es       
Xol         , Xos         , Xu          , Xu          , Re          , Gg^Es       , Gg^Es       , Gg^Es       , Re          , Gd          , Gd          , Dd          , Dd          , Gd          , Qxu         , Qxu         , Gs^Fdw      , Gs^Fdw      , Gs^Fdw      , Gs^Fdw      , Gs^Fdw      , Rb          , Gs^Fdw      , Gs^Fdw      , Gs^Fdw      , Re^Es       , Re^Es       , Re^Es       , Gs^Fdw      , Gs^Fdw      , Gs^Fdw      , Re^Es       , Re^Es       , Re^Es       , Re^Es       , Re^Es       , Re^Es       , Gs^Es       , Gs^Fdw      , Re^Es       , Re^Es       , Re^Es       
Xu          , Xu          , Hh^Es       , Re          , Re^Es       , Re^Es       , Re^Es       , Re          , Re          , Re          , Re          , Gd          , Qxu         , Dd          , Qxu         , Dd          , Dd          , Gs^Fdw      , Gs^Fdw      , Gs^Fdw      , Rb          , Rb          , Gs^Fdw      , Gs^Fdw      , Gs^Fdw      , Re^Es       , Re^Es       , Re^Es       , Gs^Fdw      , Gs^Fdw      , Gs^Fdw      , Qxu         , Gd          , Gd          , Gs^Fdw      , Re^Es       , Gd          , Gs^Fdw      , Gs^Fdw      , Gs^Fdw      , Gs^Fdw      , Gs^Fdw      
Gg^Es       , Md^Es       , Hh^Es       , Re          , Re^Es       , Re^Es       , Re^Es       , Re          , Re          , Re          , Re          , Gd          , Re^Es       , Qxu         , Re^Es       , Re^Es       , Gd          , Dd          , Dd          , Rb          , Rb          , Rb          , Gs^Fdw      , Gs^Fdw      , Gs^Fdw      , Gs^Fdw      , Gs^Fdw      , Gs^Fdw      , Gs^Fdw      , Gs^Fdw      , Gs^Fdw      , Gs^Fdw      , Gs^Fdw      , Qxu         , Qxu         , Gs^Fdw      , Gs^Fdw      , Gd          , Gd          , Gs^Fdw      , Gd          , Gd          
Dd          , Md^Es       , Hh^Es       , Gd          , Gd          , Re^Es       , Qxu         , Gd          , Gd          , Re          , Gd          , Gd          , Gd          , Re^Es       , Gd          , Gd          , Gd          , Gd          , Gd          , Dd          , Dd          , Rb          , Rb          , Gs^Fdw      , Re^Es       , Gs^Fdw      , Rb          , Gs^Fdw      , Gs^Fdw      , Gs^Fdw      , Gs^Fdw      , Gs^Fdw      , Gs^Fdw      , Gs^Fdw      , Gs^Fdw      , Qxu         , Qxu         , Gd          , Gs^Fdw      , Gs^Fdw      , Gs^Fdw      , Gd          
Gg          , Dd          , Dd          , Gd          , Gd          , Qxu         , Re          , Qxu         , Qxu         , Qxu         , Qxu         , Gd          , Gd          , Gd          , Gs^Fdw      , Gs^Fdw      , Gs^Fdw      , Gd          , Gd          , Gd          , Dd          , Rb          , Rb          , Re^Es       , Re^Es       , Re^Es       , Rb          , Gs^Fdw      , Gs^Fdw      , Gs^Fdw      , Re^Es       , Re^Es       , Re^Es       , Gs^Fdw      , Gs^Fdw      , Gs^Fdw      , Gs^Fdw      , Qxu         , Gs^Fdw      , Gs^Fdw      , Gs^Fdw      , Gs^Fdw      
Gg          , Mm          , Dd          , Gd          , Gd          , Re          , Re          , Re          , Gd          , Gd          , Gd          , Gd          , Re^Es       , Re^Es       , Gd          , Gs^Fdw      , Gs^Fdw      , Gd          , Gd          , Gd          , Dd          , Rb          , Rb          , Re^Es       , Re^Es       , Re^Es       , Rb          , Rb          , Rb          , Gs^Fdw      , Re^Es       , Re^Es       , Re^Es       , Gs^Fdw      , Gs^Fdw      , Gs^Fdw      , Rb          , Gs^Fdw      , Gs^Fdw      , Gs^Fdw      , Gs^Fdw      , Gs^Fdw      
Qxu         , Mm          , Md          , Dd          , Dd^Es       , Re          , Re          , Re          , Gd          , Gd          , Rb          , Gd          , Gd          , Re^Es       , Gd          , Gs^Fdw      , Gs^Fdw      , Gd          , Gs^Fdw      , Gd          , Gd          , Dd          , Dd          , Rb          , Rb          , Rb          , Rb          , Rb          , Rb          , Gs^Fdw      , Gs^Fdw      , Re^Es       , Gs^Fdw      , Gs^Fdw      , Rb          , Rb          , Rb          , Gs^Fdw      , Gs^Fdw      , Gs^Fdw      , Gs^Fdw      , Gs^Fdw      
Rb          , Qxu         , Qxu         , Gg^Es       , Hh^Es       , Dd^Es       , Dd^Es       , Dd          , Dd^Es       , Dd^Dr       , Rb          , Dd^Es       , Dd^Es       , Gd          , Gg          , Gs^Fdw      , Gs^Fdw      , Gs^Fdw      , Gs^Fdw      , Gs^Fdw      , Gd          , Gd          , Dd          , Rb          , Rb          , Rb          , Rb          , Rb          , Rb          , Rb          , Rb          , Gs^Fdw      , Rb          , Rb          , Rb          , Rb          , Qxu         , Qxu         , Gg          , Gs^Fdw      , Gg          , Gg          
Rb          , Md          , Qxu         , Hh^Es       , Hh^Es       , Hh^Es       , Hh^Es       , Hh          , Hh          , Dd^Es       , Dd^Dc       , Dd^Es       , Gs^Fdw      , Gs^Fdw      , Gs^Fdw      , Gs^Fdw      , Gs^Fdw      , Gs^Fdw      , Gs^Fdw      , Gs^Fdw      , Gd          , Gd          , Gd          , Dd          , Rb          , Rb          , Rb          , Rb          , Rb          , Rb          , Rb          , Rb          , Rb          , Rb          , Rb          , Qxu         , Gg          , Gg          , Urb         , Urb         , Qlf         , Gg          
Rb          , Mm          , Md^Es       , Qxu         , Hh^Es       , Hh^Es       , Hh^Es       , Hh^Es       , Hh^Es       , Rb          , Dd          , Dd          , Gs^Fdw      , Gs^Fdw      , Gs^Fdw      , Re^Es       , Re^Es       , Gd          , Gd          , Gd          , Gd          , Gd          , Gd          , Dd          , Rd          , Rd          , Rd          , Rb          , Rb          , Rb          , Rb          , Rb          , Rb          , Rb          , Qxu         , Qxu         , Urb         , Urb         , Xu          , Xu          , Xu          , Qlf         
Rb          , Hh^Es       , Hh^Es       , Hh^Es       , Hh^Es       , Hh^Es       , Hh^Es       , Hh^Es       , Re^Es       , Re^Es       , Re^Es       , Dd^Es       , Dd          , Gs^Fdw      , Dd          , Gd^Vhr      , Re^Es       , Re^Es       , Dd          , Gg^Es       , Gd          , Gd          , Qxu         , Qxu         , Rd          , Rd          , Rd          , Rb          , Rb          , Rb          , Re          , Re          , Re          , Re          , Qxu         , Urb         , Urb         , Xu          , Ce          , Ce          , Ce          , Xu          
Rb          , Hh^Es       , Hh^Es       , Hh^Es       , Gg^Es       , Hh^Es       , Gg^Es       , Gg^Es       , Re^Es       , Re^Es       , Re^Es       , Rb          , Rb          , Dd          , Rb          , Dd          , Dd          , Dd          , Re          , Dd          , Qxu         , Gd          , Qxu         , Rd          , Rd          , Rd          , Rb          , Rb          , Re          , Re          , Gd          , Gd          , Gd          , Gd          , Qxu         , Re          , Urb         , Xu          , Ce          , 2 Kud       , Ce          , Xu          
Rb          , Hh^Es       , Hh^Es       , Gg^Es       , Re          , Gg^Es       , Re          , Gg          , Gd^Vhr      , Re^Es       , Re          , Rb          , Gg^Es       , Rb          , Gg^Es       , Rb          , Re^Es       , Re          , Re          , Re          , Re          , Qxu         , Gd^Vhr      , Qxu         , Qxu         , Rb          , Re          , Re          , Gd          , Gd          , Gd          , Gd          , Gd          , Gd          , Gd          , Gd          , Urb         , Xu          , Xu          , Ce          , Xue         , Xu          
Rb          , Rb          , Re          , Re          , Rb          , Re          , Rb          , Re          , Re          , Re          , Gg^Es       , Re^Es       , Re^Es       , Gg^Es       , Gg^Es       , Re^Es       , Re^Es       , Re^Es       , Re          , Re          , Re^Es       , Re          , Re          , Gg          , Qxu         , Re          , Gd          , Gd          , Gd          , Gd          , Gd          , Gd          , Gd          , Gd          , Gd          , Gd          , Gd          , Urb         , Urb         , Xue         , Urb         , Urb^Br\     
Rb          , Re          , Rb          , Rb          , Rb^Cov      , Rb          , Rb          , Rb          , Gg^Es       , Gg^Es       , Gg^Es       , Gg^Es       , Gg^Es       , Re^Es       , Re^Es       , Re^Es       , Re^Es       , Re^Es       , Gd^Vhr      , Re^Es       , Re^Es       , Re^Es       , Re^Es       , Re          , Dd          , Gd          , Dd          , Gd          , Gd          , Gd          , Gd          , Gd          , Gd          , Gd          , Gd          , Gd          , Gd          , Gd          , Gs^Fp       , Urb         , Uu          , Uu          
Rb          , Rb          , Rb          , Ce          , 1 Ke        , Ce          , Rb          , Gg^Es       , Gg^Es       , Gg^Es       , Gg^Es       , Gg^Es       , Gg^Es       , Gg^Es       , Ur          , Re^Es       , Re^Es       , Re^Es       , Rb          , Re^Es       , Re^Es       , Re^Es       , Re^Es       , Gg^Es       , Gg^Es       , Dd          , Re^Es       , Dd          , Dd^Es       , Dd          , Dd          , Gd          , Gd          , Gd          , Gd          , Gd          , Gs^Fp       , Gs^Fp       , Gs^Fp       , Gs^Fp       , Gs^Fp       , Uu          
Rb          , Hh          , Rb          , Ce          , Urb^Cov     , Ce          , Rb          , Gg^Es       , Gg^Es       , Gg^Es       , Rb          , Rb          , Gs^Fp       , Ur          , Ur          , Re^Es       , Re^Es       , Re^Es       , Re^Es       , Rb          , Rb          , Re^Es       , Gg^Es       , Gg^Es       , Re^Es       , Re^Es       , Re^Es       , Gg^Es       , Gg^Es       , Gg^Es       , Gg^Es       , Dd          , Gd          , Gd          , Gd          , Gs^Fp       , Gs^Fp       , Gs^Fp       , Gd^Fetd     , Gs^Fp       , Gs^Fp       , Uu          
Rb          , Hh          , Hh          , Rb          , Rb          , Rb          , Gg^Es       , Rb          , Rb          , Rb          , Rb          , Gd^Vhr      , Gs^Fp       , Gs^Fp       , Ur          , Ur          , Re^Es       , Re^Es       , Re^Es       , Rb          , Rb          , Rb          , Rb          , Gg^Es       , Re^Es       , Re^Es       , Gg^Es       , Gg^Es       , Gg^Es       , Gg^Es       , Gg^Es       , Dd^Es       , Dd          , Gd          , Gd          , Gd          , Gs^Fp       , Gs^Fp       , Gs^Fp       , Gs^Fp       , Gs^Fp       , Uu          
Rb          , Md          , Md          , Hh          , Gg^Es       , Gg^Es       , Gg^Es       , Gg^Es       , Gg^Es       , Re^Es       , Gg^Es       , Gs^Fp       , Gs^Fp       , Gs^Fp       , Ur          , Ur          , Gd^Vhr      , Re^Es       , Rb          , Rb          , Rb          , Rb          , Rb          , Rb          , Rb          , Gg^Es       , Rb          , Gg^Es       , Rb          , Gg^Es       , Dd^Es       , Dd^Es       , Dd          , Gd          , Gd          , Gd          , Gd          , Gs^Fp       , Gs^Fp       , Gs^Fp       , Uu          , Uu          
Qxua        , Md          , Hh          , Hh          , Hh^Es       , Gg^Es       , Gg^Es       , Gg^Es       , Re^Es       , Re^Es       , Re^Es       , Gs^Fp       , Gg^Es       , Ur          , Ur          , Ur          , Ur          , Gs^Fdw      , Gs^Fdw      , Rb          , Rb          , Rb          , Rb          , Rb          , Rb          , Gg^Efm      , Rb          , Rb          , Rb          , Rb          , Dd          , Dd          , Dd^Es       , Gd          , Qxu         , Gd          , Gd          , Gd          , Gs^Fp       , Gs^Fp       , Gs^Fp       , Uu          
Rb          , Qxua        , Qxua        , Hh          , Hh          , Gg^Es       , Gg^Es       , Gg^Es       , Re^Es       , Re^Es       , Gg^Es       , Gg^Es       , Gg^Es       , Gg^Es       , Ur          , Ur          , Ur          , Gs^Fdw      , Gs^Fdw      , Gs^Fdw      , Rb          , Rb          , Ql          , Rb          , Ql          , Rb          , Gs^Fdw      , Qxu         , Qxu         , Rb          , Gs^Fp       , Dd^Es       , Dd^Es       , Gg^Es       , Rb          , Qxu         , Qxu         , Gs^Fp       , Gs^Fp       , Gs^Fp       , Gs^Fp       , Gs^Fp       
Rb          , Mm          , Qxua        , Md          , Hh          , Hh          , Hh          , Hh          , Hh          , Gg^Es       , Rb          , Gg^Es       , Gs^Es       , Gs^Es       , Gs^Fdw      , Ur          , Ur          , Gs^Fdw      , Gs^Fdw      , Gs^Fdw      , Rb          , Ql          , Rb          , Ql          , Rb          , Gs^Fdw      , Gs^Fdw      , Gs^Fdw      , Qxu         , Qxu         , Qxu         , Gs^Es       , Gs^Es       , Dd^Es       , Dd          , Rb          , Rb          , Gs^Fp       , Gs^Fp       , Gs^Fp       , Gs^Fp       , Gs^Fp       
Rb          , Mm          , Qxua        , Gg          , Hh          , Hh          , Hh          , Hh          , Hh          , Rb          , Rb          , Gs^Fdw      , Gs^Fdw      , Gs^Fdw      , Gs^Fdw      , Gs^Fdw      , Gs^Fdw      , Ur          , Qxu         , Qxu         , Rb          , Gg^Efm      , Rb          , Rb          , Rb          , Gs^Fdw      , Gs^Fdw      , Gs^Fdw      , Gs^Fdw      , Gs^Fdw      , Gs^Fdw      , Qxu         , Qxu         , Dd          , Dd^Es       , Rb          , Rb          , Qxu         , Qxu         , Gs^Fp       , Gs^Fp       , Gs^Fp       
Rb          , Md          , Md          , Qxua        , Rb          , Hh          , Rb          , Hh          , Rb          , Rb          , Rb          , Gs^Fdw      , Gs^Fdw      , Gs^Fdw      , Gs^Fdw      , Gs^Fdw      , Qxu         , Gs^Fdw      , Qxu         , Qxu         , Rb          , Rb          , Rb          , Rb          , Rb          , Gs^Fdw      , Gs^Fdw      , Gs^Fdw      , Gs^Fdw      , Gs^Fdw      , Gs^Fdw      , Gs^Fdw      , Gs^Fdw      , Dd^Es       , Dd^Es       , Dd^Es       , Rb          , Rb          , Gs^Fp       , Qxu         , Rb          , Rb          
Rb          , Md          , Md          , Rb          , Rb          , Rb          , Rb          , Rb          , Rb          , Rb          , Rb          , Gs^Fdw      , Gs^Fdw      , Gs^Fdw      , Qxu         , Qxu         , Qxu         , Qxu         , Gs^Fdw      , Gs^Fdw      , Rb          , Rb          , Rb          , Rb          , Rb          , Rb          , Rb          , Gs^Fdw      , Rb          , Gs^Fdw      , Re^Es       , Gs^Fdw      , Dd^Es       , Dd^Es       , Dd^Es       , Dd^Es       , Rb          , Rb          , Rb          , Gs^Fp       , Rb          , Rb          
Rb          , Md          , Rb          , Rb          , Rb          , Rb          , Rb          , Rb          , Rb          , Rb          , Gs^Fp       , Rb          , Rb          , Gs^Fdw      , Rb          , Gs^Fdw      , Gs^Fdw      , Gs^Fdw      , Gs^Fdw      , Gs^Fdw      , Rb          , Rb          , Gs^Fp       , Gs^Fp       , Gs^Fp       , Gs^Fp       , Rb          , Rb          , Rb          , Re^Es       , Re^Es       , Re^Es       , Gg^Es       , Dd^Es       , Dd^Es       , Gg^Es       , Rb          , Rb          , Rb          , Rb          , Rb          , Rb          
Rb          , Rb          , Re^Es       , Rb          , Rb          , Rb          , Gs^Fp       , Rb          , Re^Es       , Gs^Fp       , Gs^Fp       , Gs^Fp       , Gs^Fp       , Rb          , Rb          , Gs^Fdw      , Rb          , Gs^Fdw      , Rb          , Gs^Fdw      , Rb          , Gs^Fp       , Gs^Fp       , Gs^Fp       , Gs^Fp       , Gs^Fp       , Gs^Fp       , Gs^Fp       , Gs^Fp       , Re^Es       , Re^Es       , Re^Es       , Gg^Es       , Dd^Es       , Re^Es       , Re^Es       , Re^Es       , Rb          , Re^Es       , Rb          , Rb          , Rb          
Qlf         , Re^Es       , Re^Es       , Re^Es       , Gs^Fp       , Gs^Fp       , Gs^Fp       , Re^Es       , Re^Es       , Re^Es       , Gs^Fp       , Gs^Fp       , Gs^Fp       , Rb          , Rb          , Rb          , Rb          , Rb          , Rb          , Rb          , Rb          , Gs^Fp       , Gs^Fp       , Gs^Fp       , Gs^Fp       , Gs^Fp       , Gs^Fp       , Gs^Fp       , Gs^Fp       , Gs^Fp       , Gg          , Gg          , Gg          , Gg^Es       , Re^Es       , Re^Es       , Re^Es       , Re^Es       , Re^Es       , Re^Es       , Rb          , Rb          
Qlf         , Re^Es       , Re^Es       , Re^Es       , Gs^Fp       , Gs^Fp       , Gs^Fp       , Re^Es       , Re^Es       , Re^Es       , Gs^Fp       , Gs^Fp       , Gg^Efm      , Rb          , Rb          , Rb          , Rb          , Rb          , Rb          , Rb          , Rb          , Gs^Fp       , Gs^Fp       , Gs^Fp       , Gs^Fp       , Gs^Fp       , Gs^Fp       , Gs^Fp       , Gs^Fp       , Gs^Fp       , Gg          , Gg          , Gg          , Gg          , Gg          , Re^Es       , Dd          , Re^Es       , Re^Es       , Re^Es       , Rb          , Rb          
Qlf         , Qlf         , Qlf         , Qlf         , Qlf         , Gs^Fp       , Gs^Fp       , Gs^Fp       , Gs^Fp       , Gs^Fp       , Gs^Fp       , Gs^Fp       , Rb          , Rb          , Rb          , Rb          , Rb          , Rb          , Rb          , Rb          , Rb          , Rb          , Rb          , Gs^Fp       , Gg          , Gs^Fp       , Gs^Fp       , Gs^Fp       , Gs^Fp       , Gs^Fp       , Gg          , Gg          , Gg          , Gg          , Gg          , Gg          , Dd          , Rb          , Rb          , Rb          , Rb          , Rb          
